TileSize:120
EdgeSize:18
GameSize:6,8
Vertical:6,9
Horizontal:7,8
P1_pos:284,284
P2_pos:644,524
 : 
V:V
1,1,1,0,0,0,0,1,1
1,0,0,0,1,1,0,0,1
1,0,0,0,0,0,0,0,1
1,0,1,1,0,0,1,1,1
1,1,0,0,0,0,0,0,1
1,0,0,0,0,1,1,0,1
 : 
H:H
1,1,1,1,1,1,1,1
0,1,0,0,1,0,0,1
0,0,0,0,1,0,0,0
0,0,1,0,0,0,1,0
1,0,1,0,0,0,1,0
1,0,0,0,0,1,0,0
1,1,1,1,1,1,1,1
